61
10
27 29 29 0 0 0 0 0 0 0 0 0 0 0 0 0 0 0 0 0 0 0 0 0 0 0 0 0 0 0 0 0 0 36 37 0 0 0 0 0 0 0 0 0 0 0 0 0 0 0 0 0 0 0 0 0 0 0 0 0 0 
24 25 25 25 0 0 0 0 0 0 0 0 0 0 0 0 0 0 0 0 0 0 0 0 0 0 0 0 0 0 0 0 0 36 37 0 0 0 0 0 0 0 0 0 0 0 0 0 0 0 0 0 0 0 0 0 0 0 0 0 0 
0 0 0 0 0 0 0 0 0 0 0 0 0 0 0 0 0 0 0 0 0 0 0 0 0 0 0 0 0 0 0 0 0 36 37 0 0 0 0 0 30 31 32 0 0 0 0 0 0 0 0 0 0 0 0 0 0 0 0 0 0 
0 0 0 0 0 0 0 0 0 0 0 0 0 0 0 0 0 0 0 0 38 39 40 0 0 22 22 22 0 0 0 0 0 36 37 0 0 0 30 31 41 41 37 0 0 0 0 0 0 0 0 0 0 0 0 0 0 0 0 0 0 
0 0 0 0 0 0 0 0 0 0 0 0 0 0 0 0 38 39 40 0 0 0 0 0 0 29 29 29 22 22 0 0 0 36 37 0 0 0 0 0 36 41 37 0 0 22 0 0 0 0 0 0 0 0 0 0 0 0 0 0 0 
0 0 0 0 0 0 0 0 0 0 0 0 0 38 39 40 0 0 0 0 0 0 0 0 0 36 41 37 0 0 0 0 0 36 41 31 32 0 0 0 36 41 37 0 0 29 0 0 22 0 0 0 0 0 0 0 0 0 0 0 0 
22 22 22 22 22 0 22 0 22 0 0 22 0 0 0 0 0 0 0 0 0 0 0 0 0 36 41 37 0 0 0 31 31 34 34 0 0 0 0 0 41 41 37 0 0 29 0 0 29 0 0 0 0 0 0 0 0 0 0 0 0 
29 29 29 29 29 0 29 0 29 0 0 29 0 0 0 0 0 0 0 0 0 0 0 0 0 36 41 37 0 0 0 0 0 0 0 0 0 0 30 31 41 41 37 0 0 29 0 0 29 0 0 22 0 0 0 0 0 0 0 0 0 
0 0 0 0 0 0 0 0 0 0 0 0 0 0 0 0 0 0 0 0 0 0 0 0 0 36 41 37 0 0 0 0 0 0 0 0 0 30 41 41 41 41 37 0 0 29 0 0 29 0 0 29 0 0 0 0 0 0 0 0 0 
0 0 0 0 0 0 0 0 0 0 0 0 0 0 0 0 0 0 0 0 0 0 0 0 0 36 41 41 31 31 31 31 31 31 31 31 31 41 41 41 41 41 37 0 0 29 0 0 29 0 0 29 0 0 22 22 22 22 0 0 0 
